2 2 1 1 1 1 2 2 2 2 
2 1 1 1 1 1 1 2 2 2 
1 1 1 1 1 1 1 1 1 2
2 1 1 1 1 1 1 2 2 2
2 2 1 1 1 1 2 2 2 2 
2 2 2 1 1 1 1 2 2 2 
2 2 1 1 1 1 1 1 2 2
1 1 1 1 1 1 1 1 1 1
2 2 1 1 1 1 1 1 2 2
2 2 2 1 1 1 1 2 2 2
4
6
9
6
4
4
6
10
6
4
1 1 
3 1 
5 3
10
10
10
3 5
1 3 
1 1
1 