1 1 1 1 2 2 2 2 2 1
1 1 1 2 2 2 2 2 1 1
1 1 2 2 2 2 2 1 1 1
1 2 2 2 2 2 1 1 1 1
2 2 2 2 2 1 1 1 1 1
2 2 2 2 1 1 1 1 1 1
2 2 2 1 1 1 1 1 1 1
2 2 1 1 1 1 1 1 1 1
2 1 1 1 1 1 1 1 1 1
1 1 1 1 1 1 1 1 1 1
4 1
3 2
2 3
1 4
5
6
7
8
9
10
4 1
3 2
2 3
1 4
5
6
7
8
9
10