2 2 2 1 1 2 2 2 2 2
2 2 2 2 1 1 2 2 2 2
2 2 2 2 1 1 2 2 2 2
2 2 2 2 1 1 2 2 2 2 
2 2 2 2 1 1 2 2 2 2
1 1 1 1 1 1 1 1 1 1 
1 1 1 1 1 1 1 1 1 1
1 1 1 2 1 1 1 1 1 1 
1 2 2 2 1 1 2 2 2 2 
1 1 1 1 1 1 2 2 2 2
2 
2
2
2
2
10
10
3 6
1 2
6
5
3 1
3 1
1 2 1
10
9
3
3
3
3