2 2 1 1 1 1 1 1 2 2 
2 1 1 2 2 2 2 1 1 2 
1 1 2 2 2 2 2 2 1 1 
1 2 1 2 2 2 2 2 2 1
1 2 2 2 2 2 1 1 2 1 
1 1 2 2 2 1 1 1 1 1
1 1 1 1 1 1 1 1 1 1
1 1 2 1 1 1 1 1 1 1 
2 1 1 2 2 2 2 1 1 2 
2 2 1 1 1 1 1 1 2 2
6
2 2 
2 2
1 1 1 
1 2 1 
2 5 
7 2
2 7
2 2
6
6
2 4 
2 1 1 2 
1 2 1
1 2 1
1 3 1
1 4 1
2 2 3
2 4 
6