2 2 2 1 1 1 1 1 1 1
2 1 1 1 1 1 1 1 1 1 
2 2 1 1 1 1 1 1 1 1
2 2 2 1 1 1 1 1 1 1 
2 2 2 1 1 2 1 1 1 2 
2 2 2 2 1 1 1 1 1 2
2 2 2 2 1 1 1 1 1 2 
2 2 1 1 1 1 1 1 2 2
2 2 2 2 1 1 1 1 2 2 
1 1 1 1 1 1 1 2 2 2
7
9
8
7
2 3
5
5
6
4
7
1
1 1
2 1 1
5 1 1
10
4 5
10
9
7
4