2 2 2 2 2 1 1 1 1 2 
2 2 2 2 2 1 1 1 1 2 
2 2 2 2 2 2 2 1 1 2 
2 1 1 1 1 1 1 1 1 1 
1 1 1 1 1 1 1 1 1 1
1 1 1 1 1 1 1 1 1 1 
2 1 1 1 1 1 1 1 1 1 
2 2 2 2 2 2 1 1 2 2 
2 2 2 1 1 1 1 1 2 2
2 2 2 1 1 1 1 1 2 2
4
4
2
9
10
10
9
2
5
5
2
4
4
4 2
4 2
2 4 2
2 7
10
7
4