2 2 1 1 2 2 2 2 2 2 
2 1 1 2 2 2 1 1 1 1 
1 1 1 2 2 1 1 1 1 1 
1 1 1 1 1 1 1 1 1 1
1 1 1 1 1 1 2 2 2 1 
2 1 1 1 1 2 2 2 1 2 
2 2 2 2 2 2 2 1 2 1
2 2 2 2 2 2 2 1 2 1 
2 2 2 2 2 2 2 1 1 1 
2 2 2 2 2 2 2 1 1 1
2
2 4
3 5
10
6 1
4 1
1 1
1 1
3
3
3
5
6
1 3 
3
3
3
3 4 
3 1 2
4 4 