2 2 2 2 2 2 2 2 1 1 
2 2 2 2 2 2 2 2 2 1 
2 2 2 2 2 2 2 1 1 1 
1 1 1 1 1 1 1 1 1 1 
1 1 1 1 1 1 1 1 1 1
2 1 1 1 1 1 1 1 1 1
1 1 1 1 1 1 1 1 1 1
1 1 1 1 1 1 1 1 1 1
2 2 2 2 1 1 1 2 2 1 
2 2 2 2 1 2 2 2 2 2
2
1
3
10
10
9
10
10
3 1
1
2 2
5
5
5
7
6
6
6
1 6
9