2 2 2 2 2 2 2 2 2 1 
1 2 1 1 1 2 2 1 1 1 
1 1 2 1 1 1 1 1 1 1 
1 1 2 2 1 1 1 2 2 2 
1 1 2 1 1 1 1 1 1 1 
1 2 1 1 1 1 1 1 1 1
1 1 1 1 1 2 1 1 1 1
2 2 2 2 2 2 2 1 1 1
2 2 2 2 2 2 2 2 2 1
2 2 2 2 2 2 2 2 1 1
1
1 3 3 
2 7
2 3 
2 7
1 8
5 4 
3 
1
2
6
3 1
1 2
2 3
6
4
5
2 4
2 4 1
3 6 