2 2 2 2 2 2 2 1 1 1 
2 2 2 2 2 2 1 1 1 1 
2 2 2 2 2 1 1 1 1 1
2 2 2 2 1 1 1 1 1 1 
2 2 2 1 1 1 1 1 1 1
2 2 2 1 1 1 1 1 1 1
2 2 2 2 1 1 1 1 1 1
2 1 2 2 2 1 1 1 1 1
1 1 1 2 2 2 1 1 1 1
2 1 2 2 2 2 2 1 1 1
3
4
5
6
7
7
6
1 5
3 4
1 3
1
3
1
2
4
6
8
10
10
10