2 2 2 2 1 2 2 2 1 1 
2 2 2 1 1 2 2 2 1 1 
2 2 1 1 1 1 1 1 1 1 
2 1 1 1 1 1 1 1 1 1
1 1 1 1 1 1 1 1 1 1
1 1 1 1 1 2 2 2 1 1 
2 1 1 1 1 2 2 2 1 1 
2 2 1 1 1 1 1 1 1 1 
2 2 2 1 1 2 2 2 1 1 
2 2 2 2 1 2 2 2 1 1 
1 2 
2 2 
8
9
10
5 2
4 2 
8
2 2
1 2
2
4
6
8
10
3 1
3 1
3 1
10
10