2 2 2 2 2 2 2 2 2 1
2 2 1 1 1 2 2 2 1 1 
2 1 1 1 1 1 2 1 1 1 
1 1 2 2 2 1 1 1 1 1 
1 2 2 2 2 2 1 1 1 1 
1 2 2 2 2 2 1 1 1 1 
1 1 2 2 2 1 1 1 1 1 
2 1 1 1 1 1 2 1 1 1 
2 2 1 1 1 2 2 2 1 1 
2 2 2 2 2 2 2 2 2 1
1
3 2
5 3
2 5
1 4
1 4
2 5
5 3
3 2
1
4
2 2 
2 2 
2 2 
2 2 
2 2
4
6
8
10